####################
####################
####]###############
#J...........D.....#
#..................#
#.......###........#
#..................#
#.......#C#........#
#..................#
#..................#
#..................#
#..................#
####################
77777777777777777777
77777777777777777777
77777777777778777777
70000000000000000007
70000000000000000007
70000000123000000007
70000000000000000007
70000000456000000007
70000000000000000007
70000000000000000007
70000000000000000007
70000000000000000007
77777777777777777777
77777777777777777777
tilesethouse.bmp 9